#..@.####..
.....######
##.#..+...#
#...#..#..#
###..###.##
..#..#....#
.##.##.+.##
.#..+...##
.#x...x##
.#######