##### .####..
#.@.#######
#.....+...#
#...#..#..#
###..###.##
..#..#....########
.##.##.+..........#
.#..+...##   ####.#
.#x...x######...#.#
#.....#  #....#...#
 #########..##.####
     #.....##...#
    ##.####  ###
   #.x..##### #####
   #.........##...#
   #...#####......#
    ###    #..###.#
           ###....#
             #.@..#
             ######