--sss---------------
-a.x.#sssss---------
-a.....+...d--------
-a!..#..#..d--------
--#..###..#---------
--a..#....#sssssss--
-##.##.+..........d-
-a..+...##   ####.d-
-ax...x#--###...#.d-
-a....#--a....#...d-
--wwwwsss#..#..#ww--
-----a.....#a..xd---
----s#.#www--www----
---a.x..#####--###--
---a.........##...d-
---a...#www#......d-
----www----a..###.d-
------------w#....d-
-------------a.@..d-
--------------wwww--