##### .####........
#.x.#######........
#.....+...#
#...#..#..#
###..###..#
..#..#....########
.##.##.+..........#
.#..+...##   ####.#
.#x...x######...#.#
#.....#  #....#...#
 #########..#..####
     #.....##...#
    ##.####  ###
   #.x..##### #####
   #.........##...#
   #...#####......#
    ###    #..###.#
           ###....#
             #.@..#
             ######