######NNN###########
#@###..x...x########
#.###..####......###
#.###x#####.####M..#
#M..#.-#....####.###
#.###.-#.#ww####.###
#.###.-#.#NN####.###
#.1+#.-#..x..###M..#
#####.-#####.###...#
L................#..#
#1.##.######.###..##
##x##.###....####.##
##.M..#M..#####N#.##
M..##.###.##...+..##
##.##.#x..##.####.##
L#x##.#.####M..##.##
##x##.#.#NN#.####.##
##x##+#.xxx..####.##
##....##########1.!#
####################