--sssssssss---------
-h.@..+....d--------
-a.#wtttt*.d--------
-a.!.#..#..d--------
--#..#gg*.#---------
--a..#xx...#sssssss--
-##.##.+d#.+...x..d-
-a..+.#..#....###.d-
-a#...x#...##...#.d-
-a............#...d-
-a..wwsss#..#w.#ww--
-a..-a.....#a..xd---
-a..a#.#www--www----
--w.x..#####--###--
---a.....x...##...d-
---a...#www#......d-
----www----ax.###.d-
------------w#....d-
-------------a...d--
--------------wwww--