--sssssssss---------
-h.@..+....d--------
-a.#wtttt*.d--------
-a.!.#..#..d--------
--#..#gg*.#---------
--a..#....#sssssss--
-##.##.+d#........d-
-a..+.#.##---####.d-
-a#...x#--###...#.d-
-a............#...d-
-a..wwsss#..#w.#ww--
-a..-a.....#a..xd---
-a..a#.#www--www----
--w.x..#####--###--
---a.........##...d-
---a...#www#......d-
----www----a..###.d-
------------w#....d-
-------------a...d--
--------------wwww--