--sssssssss---------
-h.@..+....d--------
-a.##tttt*.d--------
-a.!.#..#..d--------
--#..#gg*.#---------
--a..#xx..##ssssss--
-##.##.+d#.+...x..d-
-a....#..#....###.f-
-a#....#.#..#...#.f-
-a............*...d-
-a..######..#w##ww--
-a..-a......#-------
-a..##.#ww#..#------
--#.x#.#####.d###---
---#.....x...##-----
---a#..#www#..d-----
----www----ax.d-----
------------ww------
--------------------
--------------------