--sssssssss---------
-h.....1...d--------
-a.#wtttt*.d--------
-a.!.#..#..d--------
--#1.#gg*.#---------
--a.##xx..##ssssss--
-##.##.+d#.....x..d-
-a....#..#....###.f-
-a#....#.#......#.f-
-a..##.......*#...d-
-a..#######.#w##ww--
-a..-a......#-------
-a..##....##..------
--#.x#.##x#ss-------
---#....a..+.#sssss-
---a#..#h.##.......f
----w#.#h.dax*ttt#.f
-----a.#x.d-ww--#..d
-----a+..#-----a@..d
------www-------www-