####################
##.x......+d-------#
#..#wttt**.#####---#
#.###---#....xx.#--#
#M..#-##..######---#
#-####--#!##-------#
1-#.##---####..-..-#
###########.x#######
#L.................#
#+...............1+#
###########.########
---------#*x*-------
----------*.*-------
---------M..*-------
----------*.*-------
----------#.#ggggg#-
-------####x.......#
#gggggggggggggg*M..#
#@........x........#
####################





