####################
##.........d-------#
#..#wtttt*.d-------#
#..!.#..#..d-------#
#M..#gg*.#---------#
#-####xx..##ssssss-#
#1#.##.+d#x....x..d#
####################
--------------------
--------------------
###########1########
-a..-a......#-------
-a####.M..##--------
--#.x#.##x#ss-------
---#....a..+.#sssss-
---a#..#h.##.......f
----w#.#h.dax*ttt#.f
-----a.#x.d-ww--#..d
-----a+..#-----a@..d
------www-------www-