####################
##.........d-------#
#..#wtttt*.d####---#
#.####..#....x..#--#
#M..####..######---#
#-####--#!##ssssss-#
1-#.##---#x....x..d#
####################
#L------------------#
#-----------------1-#
###########.########
-a..-a......#-------
-a####.M..##--------
--#.x#.##x#ss-------
---#....a..+.#sssss-
---a#..#h.##.......f
----w#.#h.dax*ttt#.f
-----a.#x.d-ww--#..d
-----a+..#-----a@..d
------www-------www-