---##############---
---#.....x......#---
---#.**********.##--
L--#....x........#--
---############+.#--
--------#####NN..#--
--------#1.......#--
--------########M#--
--------########M#--
--------#....x...#--
--------#.###NNN####
--------#..........#
########N#########.#
#...###......M..##.#
#M.x..h.*****.####.#
#M....h...+.....x..#
#@##.###**###.######
####..+...###.#-----
1x!######..x..#-----
###############-----