#######
#-----#
#--@--#
#-----#
#######