###NNNN#############
#.........x........#
#.#######NN#######.#
#.#..............#M#
#.#.############.#x#
L...................
#.#.#####NN#####.#.#
#.#M#....xx....#.#.#
##.#.########.#.#.#
##.#.#....+.#.#.#.#
#M#.#.#!****.#.#.#.#
#.#.#.###NN#.#M#.#.#
#.#.#........#.#.#.#
#.#.###NN#####.#.#.#
#.#............#+#x#
#.######NNN#####.#.#
#...xx..x........#M#
###NNN********####.#
#@.......x........x#
********************